1 13 31
###############################
#p**6s#                      x#
# s# b#
# b# f*
# f#6s#
# f# L#
# s#6*#
# b# *#
# f# b#
# L# f#
# W# *#                       #
# f#6*#                       #
###############################